111111111111111111111111111111
1                            1
1                            1
1                            1
1                            1
1                            1
1                            1
1                            1
1                            1
1                            1
1                            1
1                            1
1                            1
1                            1
1                            1
1      1111111111            1
1                            1
1  s   1111111111            1
1                            1
111111111111111111111111111111